10
10
##########
##.##.##.#
#........#
#.#.##.###
#...B..#.#
###.##...#
#.....##.#
##.##..#.#
#S..##.###
##########