17
17
#################
##.#.##.###...###
#...........##S##
##.##.#######..##
##.#..#.....#.#.#
#..#.##.###.#...#
##.#.#......##.##
#..#..#.##.#.#..#
##..#......#..#.#
##.#.##.##.##.#.#
#........#......#
##.#.#.####.###.#
#..#.###...##.#.#
##B......#.....##
##.#####.##.##..#
##.............##
#################